13 24
XXXXXXXXXXXXXXXXXXXXXXXX
X|||+|||||||+||+|||||||X
X|--|-------#---|--.--|X
X|--+.......|---|--.--|X
X|..|-------|---#--.--|X
X|--|||||||||||||--.--|X
X|--|---.---|---|--.--|X
X|||+|||||||+...|||||||X
X|--|-------|------|--|X
X+||||||||#|+|||#|||..|X
X|----|--.---------#---X
X||||||||||||||+||||---X
XXXXXXXXXXXXXXXXXXXXXXXX
2
H 21 6 N -
A 1 11 N |